20 20
2 	2	 2	 2 	2 	2 	2 	2 	2 	2 	2 	2 	2 	2 	2 	2 	2 	2 	2 	2
2 	1L 	1L 	1 	1 	1 	1 	1 	1 	1 	1 	1 	1 	1 	1 	1 	1 	1 	1 	2
2 	1L 	1 	1 	1 	1 	1 	1 	1 	1 	1 	1 	1 	1 	1 	1 	1 	1 	1 	2
2 	1L	2 	2 	2 	1 	1 	1 	1 	1 	1 	1 	1 	1 	2	1 	1 	1 	1 	2
2 	1 	1 	1 	2 	1 	1 	1 	1 	1 	1 	1 	1 	1 	2 	1 	1 	1 	1 	2
2 	1 	1 	1 	2 	1 	1 	1 	1 	1 	1 	2 	1 	1 	2 	1 	1 	1 	1 	2
2 	1 	1 	1 	2 	1 	1 	1 	1 	1 	1 	2 	1 	1 	2 	1 	1 	1 	1 	2
2 	1 	1 	1 	1 	1 	1 	1 	1 	1 	1 	1 	1 	1 	2 	1 	1 	1 	1 	2
2 	1 	1 	2 	1 	1 	1 	1 	1L 	1 	1 	1 	1 	1 	1 	1 	1 	1 	1 	2
2 	1 	1 	2 	1 	1 	1 	1 	1 	1 	1 	1 	1 	1 	1 	1 	1 	1 	1 	2
2 	1 	1 	2 	1 	1 	1 	1 	1 	1 	1 	1 	1 	1 	1 	1 	1 	1 	1 	2
2 	1 	1 	2 	1 	1 	1 	1 	1 	1 	2 	2 	2 	2 	2 	1 	1 	1 	1 	2
2 	1 	1 	2 	1 	1 	1 	1 	1 	1 	1 	1 	1 	1 	2 	1 	1 	1L 	1 	2
2 	1 	1 	1 	1 	1 	1 	1 	1 	1 	1 	1 	1 	1 	2 	1 	1 	1 	1 	2
2 	1 	1 	1 	1 	1 	1 	1 	1 	1 	1 	1 	2 	2 	2 	1 	1 	1 	1 	2
2 	1 	1 	1 	1 	1 	1 	1 	1 	1 	1 	1 	1 	1 	1 	1 	1 	1 	1 	2
2 	1 	1 	1 	1 	1 	1 	1 	1 	1 	1 	1 	1 	1 	1 	1 	1 	1 	1 	2
2 	1 	1 	1 	1 	1 	1 	1 	1 	1 	1 	1 	1 	1 	1 	1 	1 	1 	1 	2
2 	1 	1 	1 	1 	1 	1 	1 	1 	1 	1 	1 	1 	1 	1 	1 	1 	1 	1 	2
2 	2	 2	 2 	2 	2 	2 	2 	2 	2 	2 	2 	2 	2 	2 	2 	2 	2 	2 	2